-27
3
-5
13
0000000000000000000000000000000
0000000000000000000000000000000
0000000000000000000000000000000
0000000000000000000000000000000
0111111111100000000111111111100
0100000000100000000100010000100
0111111111100000000111111111100
0110001100100000000100010001100
0110000000111111111100110001100
0100000000111111111110000001100
0111100000110000001100110001100
0100000000110000001110010001100
0100000000111000011110010001100
0111100111111000011111100001100
0100100000000000000000000000100
0100000000000000000000000110100
0110000000100000000110000000100
0100000000111111111110111111100
0111111111100000000000000000000
