-33
8
-9
16
000000000000000000000000000000000000000000
000000000000000000000000000000000000000000
000000000000000000000000000000000000000000
000000000000000000000000000000000000000000
000000000000000000000000000000000000000000
000000000000000000000000000000000000000000
000000000000000000000011111111111110000000
000000000000000000000010010000000010000000
000000000000000000000010010000000010000000
000000000000000000001110011111111110000000
000000011111111111111010010001100010000000
000000011000000000000000010000000010000000
000000011000000001100000010000000010000000
000000010000000000000000011110001110000000
000000011000000000000000000000000010000000
000000010000000000001000000000000010000000
000000010000000000001100000000000010000000
000000010011001110001000010000000110000000
000000011111111111111000010111000110000000
000000000000000000001000010000000110000000
000000000000000000001000010000000010000000
000000000000000000001000011010111110000000
000000000000000000001111111111111110000000
000000000000000000000000000000000000000000
000000000000000000000000000000000000000000
000000000000000000000000000000000000000000
