-33
8
-9
16
000000000000000000000000000000000000000000
000000000000000000000000000000000000000000
000000000000000000000000000000000000000000
000000000000000000000000000000000000000000
000000000000000000000000000000000000000000
000000000000000000000000000000000000000000
000000000000000000000000000000000000000000
000000011111111110000000011111111110000000
000000010000000010000000010001000010000000
000000011111111110000000011111111110000000
000000011000110010000000010001000110000000
000000011000000011111111110011000110000000
000000010000000011111111111000000110000000
000000011110000011000000110011000110000000
000000010000000011000000111001000110000000
000000010000000011100001111001000110000000
000000011110011111100001111110000110000000
000000010010000000000000000000000010000000
000000010000000000000000000000011010000000
000000011000000010000000011000000010000000
000000010000000011111111111011111110000000
000000011111111110000000000000000000000000
000000000000000000000000000000000000000000
000000000000000000000000000000000000000000
000000000000000000000000000000000000000000
000000000000000000000000000000000000000000
