-74
60
-69
65
000000000000000000000000000000000000000000000000000000000000000000000000000000000000000000000000000000000000000000000000000000000000000
000000000000000000000000000000000000000000000000000000000000000000000000000000000000000000000000000000000000000000000000000000000000000
000000000000000000000000000000000000000000000000000000000000000000000000000000000000000000000000000000000000000000000000000000000000000
000000000000000000000000000000000000000000000000000000000000000000000000000000000000000000000000000000000000000000000000000000000000000
000000000000000000000000000000000000000000000000000000000000000000000000000000000000000000000000000000000000000000000000000000000000000
000000000000000000000000000000000000000000000000000000000000000000000000000000000000000000000000000000000000000000000000000000000000000
000000000000000000000000000000000000000000000000000000000000000000000000000000000000000000000000000000000000000000000000000000000000000
000000000000000000000000000000000000000000000000000000000000000000000000000000000000000000000000000000000000000000000000000000000000000
000000000000000000000000000000000000000000000000000000000000000000000000000000000001111111110001111111000000000000000000000000000000000
000000000000000000000000000000000000000000000000000000000000000000000000000000000001111111110001111111000000000000000000000000000000000
000000000000000000000000000000000000000000000000000000000000000000000000000000000001111111110001111111000000000000000000000000000000000
000000000000000000000000000000000000000000000000000000000000000000000000000000001111111111110001111111111110000000000000000000000000000
000000000000000000000000000000000000000000000000000000000000000000000000000000001111111111110001111111111110000000000000000000000000000
000000000000000000000000000000000000000000000000000000000000000000000000000000001111111111110001111111111110000000000000000000000000000
000000000000000000000000000000000000000000000000000000000000000000000000000000001111111111110001111111111110000000000000000000000000000
000000000000000000000000000000000000000000000000000000000000000000000000000000001111110000000000000001111110000000000000000000000000000
000000000000000000000000000000000000000000000000000000000000000000000000000000001111110000000000000001111110000000000000000000000000000
000000000000000000000000000000000000000000000000000000000000000000000000000000001111110000000000000001111110000000000000000000000000000
000000000000000000000000000000000000000000000000000000000000000000000000000000001111110000000000000001111110000000000000000000000000000
000000000000000000000000000000000000000000000000000000000000000000000000000000001111110000000000000001111110000000000000000000000000000
000000000000000000000000000000000000000000000000000000000000000000000000000000001111110000000000000001111110000000000000000000000000000
000000000000000000000000000000000000000000000000000000000000000000000000000000001111110000000000000001111110000000000000000000000000000
000000000000000000000000000000000000000000000000000000000000000000000000000000001111110000000000000001111110000000000000000000000000000
000000000000000000000000000000000000000000000000000000000000000000000000000000001111110000000000000001111110000000000000000000000000000
000000000000000000000000000000000000000000000000000000000000000000000000000000001111110000000000000001111110000000000000000000000000000
000000000000000000000000000000000000000000000000000000000000000000000000000000001111110000000000000001111110000000000000000000000000000
000000000000000000000000000000000000000000000000000000000000000000000000000000001111111111100000111111111110000000000000000000000000000
000000000000000000000000000000000000000000000000000000000000000000000000000000001111111111100000111111111110000000000000000000000000000
000000000000000000000000000000000000000000000000000000000000000000000000000000001111111111100000111111111110000000000000000000000000000
000000000000000000000000000000000000000000000000000000000000000000000000000000000000011111100000111110000000000000000000000000000000000
000000000000000000000000000000000000000000000000000000000000000000000000000000000000011111100000111110000000000000000000000000000000000
000000000000000000000000000000000000000000000000000000000000000000000000000000000000011111100000111110000000000000000000000000000000000
000000000000000000000000000000000000000000000000000000000000000000000000000000000000011111100000111110000000000000000000000000000000000
000000000000000000000000000000000000000000000000000000000000000000000000000000000000011111100000111110000000000000000000000000000000000
000000000000000000000000000000000000000000000000000000000000000000000000000000001111111111100000111110000000000000000000000000000000000
000000000000000000000000000000000000000000000000000000000000000000000000000000001111111111111011111110000000000000000000000000000000000
000000000000000000000000000000000000000000000000000000000000000000000000011111111111111111111011111110000000000000000000000000000000000
000000000000000000000000000000000000000000000000000000000000000000000011111111111111111111111111111111111000000000000000000000000000000
000000000000000000000000000000000000000000000000000000000000000000000011111111111111111111111111111111111000000000000000000000000000000
000000000000000000000000000000000000000000000000000000000000000000000011111111111111111111000000011111111111111111100000000000000000000
000000000000000000000000000000000000000000000000000000000000000000001111111111111111111111000000011111111111111111111111110000000000000
000000000000000000000000000000000000000000000000000000000000000000001111111111111111111111000000011111111111111111111111110000000000000
000000000000000000000000000000000000000000000000000000000000000000001111111111111111111111000000011111111111111111111111110000000000000
000000000000000000000000000000000000000000000000000000000000000000001111111111111110000000000000000000001111111111111111110000000000000
000000000000000000000000000000000000000000000000000000000000000000001111111000000000000000000000000000000000000001111111110000000000000
000000000000000000000000000000000000000000000000000000000000000000001111111000000000000011110001111000000000000001111111110000000000000
000000000000000000000000000000000000000000000000000000000000000000001111100000000000000011110001111000000000000000011111110000000000000
000000000000000000000000000000000000000000000000000000000000000000001111100000000000000010000000001000000000000000011111110000000000000
000000000000000000000000000000000000000000000000000000000000000000001111100000000000000010000000001000000000000000011111110000000000000
000000000000000000000000000000000000000000000000000000000000000000001111100000000000000010000000001000000000000000011111110000000000000
000000000000000000000000000000000000000000000000000000000000000000001111100000000000000010000000001000000000000000011111110000000000000
000000000000000000000000000000000000000000000000000000000000000000001111100000000000000010000000001000000000000000011111110000000000000
000000000000000000000000000000000000000000000000000000000000000000001111100000000000000010000000001000000000000000011111110000000000000
000000000000000000000000000000000000000000000000000000000000000000001111111111111000000010000000001000000011111111111111110000000000000
000000000000000000000000000000000000000000000000000000000000000000001111111111111000000010000000001000000011111111111111110000000000000
000000000000000000000000000000000000000000000000000000000000000000111111111111111000000010000000001000000011111111111111000000000000000
000000000000000000000000000000000000000000000000000000000000000000111111111111111000000010000000001000000011111111111111000000000000000
000000000000000000000000000000000000000000000000000000000000000000111111111111111000000010000000001000000011111111111111000000000000000
000000000000000000000000000000000000000000000000000000000000000000111111111111111000000011110001111000000011111111111111000000000000000
000000000000000000000000000000000000000000000000000000000000000000111111111111111000000000000000000000000011111111111111000000000000000
000000000000000000000000000000000000000000000000000000000000000000111111111111100000000000000000000000000000111111111111000000000000000
000000000000000000000000000000000000000000000000000000000000000000111111111111100000000000000000000000000000111111111111000000000000000
000000000000000000000000000000000000000000000000000000000000000000111111111111100000000000000000000000000000111111111111000000000000000
000000000000000000000000000000000000000000000000000000000000000000111111111111100000000000000000000000000000111111111111000000000000000
000000000000000000000000000000000000000000000000000000000000000000111111111111100000000000000000000000000000111111111111000000000000000
000000000000000000000000000000000000000000000000000000000000000000111111111111111111111111111011111111111111111111111111000000000000000
000000000000000000000000000000000000000000000000000000000000000000111111111111111111111111111011111111111111111111111111111100000000000
000000000000000000000000000000000000000000000000000000000000000000111111111111111111111111111111111111111111111111111111111100000000000
000000000000000000000000000000000000000000000000000000000000000000111111111111111111111111111111111111111111111111111111111100000000000
000000000000000000000000000000000000000000000000000000000000000000111111111111100000000011111111111000000000000111111111111100000000000
000000000000000000111111111111111111111111111111000000000000000000111111111111100000000000000000000000000000000111111111111100000000000
000000000000000000111111111111111111111111111111000000000000000000111111111111100000000000000000000000000000000111111111111100000000000
000000000000000000111111111111111111111111111111000000000000000001111111111100000000000000000000000000000000000111111111111100000000000
000000000000000111111111111111111111111111111111111100000000000001111111111100000000000011100000111000000000000111111111111100000000000
000000000000000111111111111111111111111111111111111100000000000001111111111100000000000011100000111000000000000111111111111111100000000
000000000011111111111111111111111111111111111111111111111111111111111110000000000000000011100000111000000000000111111111111111100000000
000000000011111111111111111111111111111111111111111111111111111111111110000000000000000010000000001000000000000111111111111111100000000
000000000011111111111111111111111111111111111111111111111111111111111110000000000000000010000000001000000000000111111111111111100000000
000000000011111111110000000000001110000000000001111111111111111111111110000000000000000010000000001000000000000111111111111111100000000
000000000011111111110000000000000000000000000001111111111111111111111110000011111111111110000000001111111111111111111111111111100000000
000000000011111111000000000000000000000000000000011111111111111111111110000011111111111110000000001111111111111111111111111111100000000
000000000011111111000000000000000000000000000000011111111111111111111110000011111111111110000000001111111111111111111111111111100000000
000000000011111111000000000000000000000000000000011111111111111111111110000011000000000000000000000000000000000000000011111111100000000
000000000011111111000000001111000000000000011110011111111111111111111110000010000000000000000000000000000000000000000011111111100000000
000000000011111111000000001111000000000000011110011111111111111111111110000010000000000111111111111000000000000000000011111111100000000
000000000011111111000000001111000000000000011110011111111111111111111110000010000000011111111111111000000000000000000011111111100000000
000000000011111111000000001111000000000000011110011111111111111111111111111110000000011101111111101110000000000000000011111111100000000
000000000011111111000000001111000000000000011110011111111111111111111111111110000000010001111111100010000000000000000011111111100000000
000000000011111111000000001111000000000000011110011111111111111111111111111110000000010001111111100010000000000000000011111111100000000
000000000011111111000000000000000000000000000000000000000000000001111110000000000000010001111111100010000000000000000011111111100000000
000000000011111111000000000000000000000000000000000000000000000001111110000000000000010001111111100010000000000000000011111111100000000
000000000011111111000000000000000000000000000000000000000000000001111110000000000000010001111111100010000000000000000011111111100000000
000000000011111111000000000000000000000000000000000000000000000001111110000000000000010000000000000010000000011111111111111111100000000
000000000011111111000000000000000000000000000000000000111111111001111110000000000000011000000000000110000000011111111111111111100000000
000000000011111111000000000000000000000000000000000000111111111001111110000000000000001111110011111100000000011111111111111111100000000
000000000011111111000000000000000000000000000000000000111111111001111110000000000000000000000000000000000000011111111111111111100000000
000000000011111111000000000000000000000000000000000000111111111000000000000000000000000000000000000000000000011111111111111111100000000
000000000011111111000000000000000000000000000000000000111111111000000000000000000000000000000000000000000000011111111111000000000000000
000000000011111111000000000000000000000000000000000000111111111000000000000000000000000000000000000000000000011111111111000000000000000
000000000011111111000000001111000000000000000000000000111111111000000000000000000000000000000000000000000000011111111111000000000000000
000000000011111111000000001111000000000000011110000000111111111000000000000000000000000000000000000000000000011111111111000000000000000
000000000011111111000000001111000000000000011110000000111111111111111111111111111111110000000000000011111111111111111111000000000000000
000000000011111111000000001111000000000000011110000000111111111111111111111111111111110000000000000011111111111111111111000000000000000
000000000011111100000000001111000000000000011110000000111111111111111111111111111111110000000000000011111111111111111111000000000000000
000000000011111100000000001111000000000000011110000000111111111111111111111111111111110000000000000011111111111111111111000000000000000
000000000011111100000000000000000000000000000000000000111111111111111111111111111111110000000000000011111111111111111111000000000000000
000000000011111100000000000000000000000000000000000000111111111111111111111111111111110000000000000011111111111111111111000000000000000
000000000011111100000000000000000000000000000000000000111111111111111111111111111111110000000000000011111111110000000000000000000000000
000000000011111100000000000000000000000000000000000000111111111111111111111111111111110000000000000011111111110000000000000000000000000
000000000011111100000000000000000000000000000000000000111111111111111111111111111111110000000000000011111111110000000000000000000000000
000000000011111111000000000000000011111111111111111111111111111111111111111111111111110000000000000011111111110000000000000000000000000
000000000011111111000000000000000011111111111111111111111111111000000000000011111111110000000000000011111111110000000000000000000000000
000000000000111111111111111111111111111111111111111111100000000000000000000011111111110000000000000011111111110000000000000000000000000
000000000000111111111111111111111111111111111111111111100000000000000000000011111111110000000000000011111111110000000000000000000000000
000000000000111111111111111111111111111111111111111111100000000000000000000011111111110000000000000011111111110000000000000000000000000
000000000000111111111111111111111111111111111111111111100000000000000000000011111111110000000000000011111111110000000000000000000000000
000000000000000001111111111111111110000000000000000000000000000000000000000011111111110000000000000011111111110000000000000000000000000
000000000000000001111111111111111110000000000000000000000000000000000000000011111111110000000000000011111111110000000000000000000000000
000000000000000000000000000000000000000000000000000000000000000000000000000011111111110000000000000011111111110000000000000000000000000
000000000000000000000000000000000000000000000000000000000000000000000000000011111111111111110111111111100000000000000000000000000000000
000000000000000000000000000000000000000000000000000000000000000000000000000011111111111111110111111111100000000000000000000000000000000
000000000000000000000000000000000000000000000000000000000000000000000000000011111111111111110111111111100000000000000000000000000000000
000000000000000000000000000000000000000000000000000000000000000000000000000000000011111111111111111111100000000000000000000000000000000
000000000000000000000000000000000000000000000000000000000000000000000000000000000011111111111111111111100000000000000000000000000000000
000000000000000000000000000000000000000000000000000000000000000000000000000000000011111111000001111111100000000000000000000000000000000
000000000000000000000000000000000000000000000000000000000000000000000000000000000011111111000001111111100000000000000000000000000000000
000000000000000000000000000000000000000000000000000000000000000000000000000000000011111111000001111111100000000000000000000000000000000
000000000000000000000000000000000000000000000000000000000000000000000000000000000011111111000001111111100000000000000000000000000000000
000000000000000000000000000000000000000000000000000000000000000000000000000000000011111111000001111111100000000000000000000000000000000
000000000000000000000000000000000000000000000000000000000000000000000000000000000011111111000001111111100000000000000000000000000000000
000000000000000000000000000000000000000000000000000000000000000000000000000000000011111111000001111111100000000000000000000000000000000
000000000000000000000000000000000000000000000000000000000000000000000000000000000011111111000001111111100000000000000000000000000000000
000000000000000000000000000000000000000000000000000000000000000000000000000000000011111111000001111111100000000000000000000000000000000
000000000000000000000000000000000000000000000000000000000000000000000000000000000011111111000001111111100000000000000000000000000000000
000000000000000000000000000000000000000000000000000000000000000000000000000000000000000000000000000000000000000000000000000000000000000
