-17
23
-10
12
00000000000000000000000000000000000000000
11111111111111111111111111111111111111110
00000000000000000000000000000000000000000
00000000000000000000000000000000000000000
00000000000000000000000000000000000000000
00000000000000000000000000000000000000000
00000000000000000000000000000000000000000
00000000000000000000000000000000000000000
00000000000000000000000000000000000000000
00000000000000000000111111100000000000000
00000000000000000000111111100000000000000
00000000000000000000111111100000000000000
00000000000000000000111111100000000000000
00000000000000000010111111100000000000000
00000000000000000000111111100000000000000
00000000000000000000111111100000000000000
00000000000000000000000000000000000000000
00000000000000000000100000000000000000000
00000000000000000000000000000000000000000
00000000000000000000000000000000000000000
00000000000000000000000000000000000000000
00000000000000000000000000000000000000000
00000000000000000000000000000000000000000
