-55
28
-45
47
000000000000000000000000000000000000000000000000000000000000000000000000000000000000
000000000000000000000000000000000000000000000000000000000000000000000000000000000000
000000000000000000000000000000000000000000000000000000000000000000000000000000000000
000000000000000000000000000000000000000000000000000000000000000000000000000000000000
000000000000000000000000000000000000000000000000000000000000000000000000000000000000
000000000000000000000000000000000000000000000000111111111111111111111110000000000000
000000000000000000000000000000000000000000000001111111111111111111111110000000000000
000000000000000000000000000000000000000000000001111111111111111111111110000000000000
000000000000000000000000000000000000000000000001111111111111111111111110000000000000
000000000000000000000000000000000000000000000001111100011111111111111110000000000000
000000000000000000000000000000000000000000000001111100011111111111111110000000000000
000000000000000000000000000000000000000000000001111100011000000000111110000000000000
000000000000000000000000000000000000000000000011111100011000000000111110000000000000
000000000000000000000000000000000000000000000011111100011111100111111111111100000000
000000000000000000000000000000000000000000000011111100011111100111111111111100000000
000000000000000000000000000000000000000000000011111100011111100111111111111111110000
000000000000000000000000000000000000000000000011111000000000000000011111111111110000
000000000000000000000000000000000000000111111111111111111000011111111111111111110000
000000000000000000000000000000000000000111111111111111111000011111111111111111110000
000000000000000000000000000000000000000111111111111111111000011111111111111111110000
000000000000000000000000000000000000000111111111111111111000011111111111111111110000
000000000000000000000000000000000000000111111111111111111000011111111111111111110000
000000000000000000000000000000000000000111111111111111111000011111111111111111110000
000000000000000000000000000000000000000111111111111111111100111111111111111111110000
000000000000000000000000000000000000000111111111111111111100111111111111111111110000
000000000000000000000000000000000000000111111000011111111111111111111000011111110000
000000000000000000000000000000000000000111111000011111000000000000111000011111110000
000000000000000000000000000000000000000111111000011100011100000111111000011111110000
000000000000000000000000000000000000000111111000011000000000000000111000011111110000
000000000000000000000000000000000000000111111000011000000000000000011000011111110000
000000000000000000000000000000000000000111111000011001000000000010011000011111110000
000000000000000000000000000000000000000111111000011000000000000000011000011111110000
000000000000000000000000000000000000000111111000011000000000000000011000011111110000
000000000000000000000000000000000000000111111000011000000000000000011000011111110000
000000000000000000000000000000000000000111111000011000000000000000011000011111110000
000000000000000000000000000000000000000111111000011001000000000010011000011111110000
000000000000000000000000000000000000000111111000011000000000000000011000011111110000
000000000000000000000000000000000000000111111000011100011100111000111000011111110000
000000000000000000000000000000000000000111111000011111111100111111111000011111110000
000000000000000000000000000000000000000111111000011111111100111111111000011111110000
000000000000000000000000000000000000000111111000001111111111111111111000011111110000
000000000000000000000000000000000000000111111000001111111100111111110000011111110000
000000000000000000000000000000000000000111111000000000000000000000000000011111110000
000000000000000000000000000000000000000111111000001000000000000000010000011111110000
000000000000000000000000000000000000000111111111111111100000000111111111111111110000
000000000000000000000000000000000000000111111111111111100000000111111111111111110000
000000000000000000000000000000000000000111111111111111100000000111111111111111110000
000000000000000000000000000000000000000111111111111111100000000111111111111111110000
000000000000000000000000000000000000000111111111111111100000000111111111111111110000
000000000000000000000000000000000000000111111111111111111000011111111111111111110000
000000000000000000000000000000000000000111100000000000011000011000000000011111110000
000000000000000000000000000000000000000111110000000000000000000000000000111111110000
000000000000000000000000000000000000000111110000000011110000011100000000111111110000
000000000000000000000000000000000000000111110111111011110000011101100110111110000000
000000000000000000000000000000000000000111110111111011110000011101111110111110000000
000000000000000000000000000000000000000111110111111011100001101101000010111110000000
000000000000000000000000000000000000000111100100001011100000000001000010011110000000
000000000000000000000000000000000000000111000100001000000000000001000010001110000000
000000000111111111111111111110000000000111100110011000000000001111111110011110000000
000000000111111111111111111111111111111111110111111001100000001111111110111110000000
000000000111111111111111111111111111111111110110011001100000001111111110111110000000
000000000111111111111111111111111111111111110000000001110000011111111110111100000000
000000001111111111111111111111111111111111110000000000000000011111111110111110000000
000000000110000000110000000111111111111111100000000000000000011111111110111110000000
000000000110000000110000000110000001111011101111111111110000011111111110011110000000
000000000110000000110000000110000000000011101111111111110000011111111111011110000000
000000000110000000110000000110000000000011101111111111100000001111111111011110000000
000000000110000001110000000110000011111111111111111111110000011111111111111110000000
000000000111110011111110011111110011111111111111111111110000011111111111111111110000
000000000111111111111111111111111111111111111111111111110000011111111111111111110000
000000000111110011111110011111110011111111111111111111110000011111111111111111110000
000000000111000000000000000000000000000000000000000000000000000000000000000001110000
000000000111000000000000000000000000000000000000000000000000000000000000000001110000
000000000111000000000000000000000000000000000000000000011111111100000000000001110000
000000000111111000001111111100111111111100111111111100111111111111111111100111110000
000000000111111000001111111111111111111111111111111111111111111111111111111111110000
000000000111110000000111111100111111111100111111111000111111111111111111100111110000
000000000111110000000110000000000110000000000111111000111111110000000011000011110000
000000000111110000000110000000000110000000000110000000000011110000001111000011110000
000000000011110000000110000000000110000000000110000000000011111100000011000011110000
000000000011110000000110000000000110000000000111100000000011111100000111000011110000
000000000001110000000111100000000110000000000111100000000011110000001111000011110000
000000000001110000000111100000000111110000000111100000000000000000001111000011110000
000000000001110000000111100000000111110000111111111111110000000011111111111111110000
000000000001110000000111111111111111111111111111111111111111111111111111111111110000
000000000001110000000111111111111111111111111111111111111111111111111111111111110000
000000000001111100011111111111111111111111111111111111111111111111111111111111110000
000000000001111100011111111111111111111111111111111111111111111111111111111111110000
000000000001111100011111111111111111111111111111111111111111111111111111111111110000
000000000001111100011111111111111111111111111111111111111111111111111111111111110000
000000000001111111111111111111111111111111111111111111111111111111111111111111110000
000000000000000000000000000000000000000000000000000000000000000000000000000000000000
000000000000000000000000000000000000000000000000000000000000000000000000000000000000
