-81
29
-88
45
000000000000000000000000000000000000000000000000000000000000000000111111111111110000000000000000000000000000000
000000000000000000000000000000000000000000000000000000000000000000111111111111110000000000000000000000000000000
000000000000000000000000000000000000000000000000000000000000011111111111111111111111111100000000000000000000000
000000000000000000000000000000000000000000000000000000000000011111111111111111111111111100000000000000000000000
000000000000000000000000000000000000000000000000000000000000011111111111111111111111111100000000000000000000000
000000000000000000000000000000000000000000000000000000000111111111100000000000011111111100000000000000000000000
000000000000000000000000000000000000000000000000000000000111111111100000000000011111111110000000000000000000000
000000000000000000000000000000000000000000000000000111111111111111100000000000011000111110000000000000000000000
000000000000000000000000000000000000000000000000000111111111111111100000000000011000111110000000000000000000000
000000000000000000000000000000000000000000000000000111111110000000000000000000000000011110000000000000000000000
000000000000000000000000000000000000000000000000000111111110000000000000000000000000011110000000000000000000000
000000000000000000000000000000000000000000000000001111111110000000000000000000000000011110000000000000000000000
000000000000000000000000000000000000000000000000001111111110000000000000000000000000011110000000000000000000000
000000000000000000000001111111111111111111111111111111111110000000000000000000000000011110000000000000000000000
000000000000000000000001111111111111111111111111111111111110000000000111000111000000011110000000000000000000000
000000000000000000001111111111111111111111111111111100000000000000000111000111000000011110000000000000000000000
000000000000000000001111111111111111111111111111111100000000000000000111000111000000011110000000000000000000000
000000000000000000001111111111111111111111111111111000000000000000000111000111000000011110000000000000000000000
000000000000000000001111000000000000000000000001111000000000000000000111000111000000011110000000000000000000000
000000000000000000001111000000000000000000000001111000111111111111111111000111111111111110000000000000000000000
000000000000000000001111000000000000000000000001111000111111111111111111000111111111111110000000000000000000000
000000000000000000001111000000000000000000000001111000111111111111111111000111111111111000000000000000000000000
000000000000000000001111000001000000000001000001111000111111111111111111111111111111111000000000000000000000000
000000000000000000001111000000011100011100000001111000111111111111111111111111111000000000000000000000000000000
000000000000000000001111000001110000000111000001111000111111111111111111111111111000000000000000000000000000000
000000000000000000001111000001000000000001000001111000111110000000000000000000000000000000000000000000000000000
000000000000000000001111100001000000000001000011111000111110000000000000000000000000000000000000000000000000000
000000000000000000001111100001011110111101000111111000111110000000000000000000000000000000000000000000000000000
011111111111111111100011111001000000000001011111110001111110000000000000000000000000000000000000000000000000000
011111111111111111111111111001011110111101011111100011111100000000000000000000000000000000000000000000000000000
011111111111111111111110111001000000000001011111000111111100000000000000000000000000000000000000000000000000000
011111111111111111111110111000011110111101011110001111110000000000000000000000000000000000000000000000000000000
011111111111111111111110111000000000000001000000011111100000000000001111111111111111111111110000000000000000000
011110000000000000011110111001000000000001000000111111000000000011111111111111111111111111110000000000000000000
011110000000000000011111111001000000000001011111111111000000000011111111111111111111111111110000000000000000000
011110010000000010011111111001110000000111011111111100000000000011111111111111111111111111110000000000000000000
011110000000000000011111111001011000001101011111111100000000000011111111111111111111111111111000000000000000000
011110000000000000011111111000000000000000011111111100000000000011111000000000000000000011111100000000000000000
011110000000000000000000000000000011100000011111111100000000000011110000000000000000000001111100000000000000000
011110000000000000000000000000000111110000011111111100000000000011110000000000000000000001111100000000000000000
011110000000000000000000000000000111110000011111111100000000000011110000000000000000000001111100000000000000000
011110000000000000011111111100000111110000011111111100000000000011110000000000000000000001111100000000000000000
011110000000000000111111111100000111110000011111111100000000000011110000000000000000000001111100000000000000000
011110010000000010111111111100000111110000011111111100000000000011110000000000000000000001111100000000000000000
011110000000000000111111111100000111110000011111111100000000000011110000000000000000000001111100000000000000000
011111111111111111111111111100000111110000011110000000000000000011111000000000000000000011111100000000000000000
011111111111111111111111111100000111110000011110000000000000000011111111111100000111111111111100000000000000000
011111111111111111110000111100000111110000011110000000000000000011111111111100000111111111111100000000000000000
011111111111111111110000111100000111110000011110000000000000000011111111111100000111111111111100000000000000000
000000000000000000000000111100000111110000011110000000000001111111111111111100000111111111111100000000000000000
000000000000000000000000111100000111110000011110000000000001111111111111111110001111111111111111111110000000000
000000000000000000000000111100000111110000011110000000000001111111111111111110001111111111111111111110000000000
000000000000000000000000111110000011100000111110000000001111111111111111111100000111111111111111111110000000000
000000000000000000000000111111000000000001111110000000001111111111111111111100000111111111111111111110000000000
000000000000000000000000111111000000000001111100000000001111111111111111111100000111111111111111111110000000000
000000000000000000000000111111100000000011111000000000001111111111111111111100000111111111111111111110000000000
000000000000000000000000000111111100011111111000000000001111111111111111111100000111111111111111111110000000000
000000000000000000000000011111111100011111100000000000001111111111111111111100000111111111111111111110000000000
000000000000000000000000011111111100011110000000000000001111111111111111111100000111111111111111111110000000000
000000000000000000000000011111111100011110000000000000001111111000000000111111111111100000000011111110000000000
000000000000000000000000011111111100011111100000000000001111111000000000100000000000100000000011111110000000000
000000000000000000000000011111111100011111100000000000001111111000000000000000000000000000000011111110000000000
000000000000000000000000011111111100011111100000000000001111111000000000000001110000000000000011111110000000000
000000000000000000000000011111111100011111111111100000001111111000000000011111111111000000000011111110000000000
000000000000000000000000011111111100011111111111100000001111111000000000111111111111100000000011111110000000000
000000000000000000000000011111111100011111111111100000001111111000000000111111111111100000000011111110000000000
000000000000000000000000011111111100011111111111100000001111111000000000111111111111100000000011111110000000000
000000000000000000000000011111111100011111111111100000001111111110000111111111111111111100001111111110000000000
000000000000000000000000011111111100011111111111100000001111111110000111111111111111111100001111111110000000000
000000000000000000000000011111111100011111111111100000001111111110000111111111111111111100001111111110000000000
000000000000000000000000011110000000000000111111100000001111111110000111111111111111111100001111111110000000000
000000000000000000000000011110000000000000111111100000001111111110000000000000000000000000001111111110000000000
000000000000000000000000011110000000000000111111100000001111111110000000000000000000000000001111111110000000000
000000000000000000000000011110000000000000111111100000001111111110000000000000000000000000001111111110000000000
000000000000000000000000011110000000000000111111100000001111111110000000000000000000000000001111111111111000000
000000000000000000000000011110000000000000111111100000001111111111111111111100000111111111111111111111111000000
000000000000000000000000011110000000000000111111100000001111111111111111111100000111111111111111111111111000000
000000000000000000000000011110000000000000111111100000001111111111111111111100000111111111111111111111111000000
000000000000000000000000011110000000000000111111100000001111111111111111111100000111111111111111111111111000000
000000000000000000000000011110000000000000111111100000001111111111111111111100000111111111111111111111111000000
000000000000000000000000011110000111110000111111100000001111111111111111111100000111111111111111111111111000000
000000000000000000000000011111111100011111111111100000001111000000011111000000000000011111000000011111111000000
000000000000000000000000011111111100011111111111100000001111000000011111000000000000011111000000011111111000000
000000000000000000000000011111111100011111111111111111111111000000011111000000000000011111000000011111111000000
000000000000000000000000000011111100011111111111111111111111000000000001000000000000010000000000011111111000000
000000000000000000000000000011111100011111111111111111111111000000000000000000000000000000000000011111111000000
000000000000000000000000000011111100011111111111111111111111000000000000000000000000000000000000011111111000000
000000000000000000000000000001111100011111111111111111111111000000000000000000000000000000000000011111111000000
000000000000000000000000000001111100011111111111111111111111000000011100000000000000001111000000011111111000000
000000000000000000000000000001111100011111111111111111111111000000011111000000000000011111000000011111111000000
000000000000000000000000000001111100011111111111111111111111000000011111000000000000011111000000011111111000000
000000000000000000000000000001111100011111111111111111111111111111111111000000000000011111111111111111111000000
000000000000000000000000000001111100011111111111111111111111111111111111111100000111111111111111111111111000000
000000000000000000000000000001111100011111111111111111111111111111111111111100000111111111111111111111111100000
000000000000000000000000000001111100011111111111111111111111111111111111111100000111111111111111111111111100000
000000000000000000000000000001111100011111111111111111111111111111111111111100000111111111111111111111111100000
000000000000000000000000000001111100011111111111111111111111111111111111111100000111111111111111111111111100000
000000000000000000000000000001111100011111111111111111111111111111111111111100000111111111111111111111111100000
000000000000000000000000000001111100011111111111111111111111111111111111111100000111111111111111111111111100000
000000000000000000000000000001111100011100001111111111100000000000000000000000000000000000000000000000111100000
000000000000000000000000000001111100000000000000000000000000000000000000000000000000000000000000000000111100000
000000000000000000000000000001111100000000000000000000000000000000000000000000000000000000000000000000111100000
000000000000000000000000000001111100000011110000000000011111111111111111111111111111111111000000000000111100000
000000000000000000000000000001111111111111111111111111111111111111111111111111111111111111111111111000111100000
000000000000000000000000000001111111111111111111111111111111111111111111111111111111111111111111100000111100000
000000000000000000000000000001111111111111111111111111111111111111111111111111111111111111111110000000111100000
000000000000000000000000000000000111111111111111111111100000111111111111111111111111111110000000001111111100000
000000000000000000000000000000000111111111111110000000000000111111111111111111111111111100000000111111111100000
000000000000000000000000000000000000000000000000000000000000111111111111111111111111111100000011111111111100000
000000000000000000000000000000000000000000000000000000000000111111111111111111111111111100000111111111111100000
000000000000000000000000000000000000000000000000000000000000111111111111111111111111111100000111111111111100000
000000000000000000000000000000000000000000000000000000000000111111100000000000000000000000000111111111111100000
000000000000000000000000000000000000000000000000000000000000111111100000000000000000000000000111111111111100000
000000000000000000000000000000000000000000000000000000000000111111100000000000000000000000000111111111111100000
000000000000000000000000000000000000000000000000000000000000111111100000000000000011110000000111111111111100000
000000000000000000000000000000000000000000000000000000000000111111100000000000001111111111111111111111111100000
000000000000000000000000000000000000000000000000000000000000111111100000000000001111111111111111111111111100000
000000000000000000000000000000000000000000000000000000000000111111100000000000001111111111111111111111111100000
000000000000000000000000000000000000000000000000000000000000111111100000000000001111111111111111111111111100000
000000000000000000000000000000000000000000000000000000000000111111100000000000001111111100000000000000000000000
000000000000000000000000000000000000000000000000000000000000111111100000000000001111111100000000000000000000000
000000000000000000000000000000000000000000000000000000000000111111100000000000001111111100000000000000000000000
000000000000000000000000000000000000000000000000000000000000111111100000000000001111111100000000000000000000000
000000000000000000000000000000000000000000000000000000000000111111111111000001111111111100000000000000000000000
000000000000000000000000000000000000000000000000000000000000111111111111000001111111111100000000000000000000000
000000000000000000000000000000000000000000000000000000000000111111111111000001111111111100000000000000000000000
000000000000000000000000000000000000000000000000000000000000111111111111000001111111111100000000000000000000000
000000000000000000000000000000000000000000000000000000000000111111111111000001111111111100000000000000000000000
000000000000000000000000000000000000000000000000000000000000111111111111000001111111111100000000000000000000000
000000000000000000000000000000000000000000000000000000000000111111111111111111111111111100000000000000000000000
000000000000000000000000000000000000000000000000000000000000111111111111111111111111111100000000000000000000000
000000000000000000000000000000000000000000000000000000000000111111111111111111111111111100000000000000000000000
000000000000000000000000000000000000000000000000000000000000000000000000000000000000000000000000000000000000000
000000000000000000000000000000000000000000000000000000000000000000000000000000000000000000000000000000000000000
