-49
45
-49
54
00000000000000000000000000000000000000000000000000000000000000000000000000000000000000000000000
00000000000000000000000000000000000000000000000000000000001111111111111000000000000000000000000
00000000000000000000000000000000000000000000000000000000001111100111111000000000000000000000000
00000000000000000000000000000000000000000000000000000000001111100111111000000000000000000000000
00000000000000000000000000000000000000000000000000000000001111100111111000000000000000000000000
00000000000000000000000000000000000000000000000000000000001111100111111000000000000000000000000
00000000000000000000000000000000000000000000000000000000001111100111111000000000000000000000000
00000000000000000000000000000000000000000000000000000000111111100111111000000000000000000000000
00000000000000000000000000000000000000000000000000000000111111100111111000000000000000000000000
00000000000000000000000000000000000000000000000000000000111111100111111111000000000000000000000
00000000000000000000000000000000000000000000000000000111111100000000011111000000000000000000000
00000000000000000000000000000000000000000000000000000111111100000000011111000000000000000000000
00000000000000000000000000000000000000000000000000011111111111100011111111111110000000000000000
00000000000000000000000000000000000000000000000000011111111111111111111111111110000000000000000
00000000000000000000000000000000000000000000000000011111111100000000011111111110000000000000000
00000000000000000000000000000000000000000000000000011110000000000000000000111110000000000000000
00000000000000000000000000000000000000000000000000011100001000000000001000011111000000000000000
00000000000000000000000000000000000000000000000000011100001000000000001000011111000000000000000
00000000000000000000000000000000000000000000000000011100000000001000000000011111000000000000000
00000000000000000000000000000000000000000000000000011100000000001000000000011111000000000000000
00000000000000000000000000000000000000000000000000011100000000000000000000011111000000000000000
00000000111111111111111111100000000000000000000000011100001000000000001000011111000000000000000
00000000111111111111111111100000000000000000000000011100001000000000001000011111000000000000000
00000000111111111111111111111111100000000000000000011110000000000000000000111100000000000000000
00000000111111111111111111111111100000000000000000011111000000000000000001111100000000000000000
00000000111111111111111111111111100000000000000001111111111000000000001111111100000000000000000
00000000111111111111111111111111100000000000000000011111111100000000011111111000000000000000000
00000000111100000000000000111111100000000000000000011111111100000000011111111000000000000000000
00000000111100000000000000111111100000000000000000000011111100000000011110000000000000000000000
00000000111100000000000000111111100000000000000000000011111100000000011111111111110000000000000
00000000111100000000000000111111111111111111111111111111111100000000011111111111110000000000000
00000000111100000000000000111111111111111111111111111111111100000000011111111111111110000000000
00000000111100000000000000111111111111111111111111111111111100000000011111111111111111111000000
00000000111100000000000000111111111111111111111111111111111100000000011111111111111111111100000
00000000111100000000000000111111111111111111111111111111111100000000011111111111111111111110000
00000000111100000000000000011100000000000011100000000000011100000000011100000000000000111110000
00000000111100000000000000000000000000000000000000000000000000000000000000000000000000011110000
00000000111100000000000000000000000000000000000000000000000000000000000000000000000000011110000
00000000111100000000000000000000000000000000000000000000000000000000000000000000000000011110000
00000000111100000000000000000000000000000000000000000000000000000000000000000000000000011110000
00000000111100000000000000111111111100000000000000000000000000000000000000000000000000011110000
00000000111100000000000000111111111100000000000000000000000000000000000000000000000000011110000
00000000111100000000000000111111111100000000000000000000000000000000000000000000000000011110000
00000000111100000000000000111111111100000011111111111111111111111111111111111111111111111110000
00000000111100000000000000111111111100000111111111111111111111111111111111111111111111111110000
00000000111100000000000000111111111100000111111111111111111111111111111111111111111111111100000
00000000111111110000000011111111111100000111111111111111111111111111111111111111111111111100000
00000000111111111000000111111111111100000111111111111111111111111110000000000000000000000000000
00000000111111111000000111111111111100000011111111111111111111111110000000000000000000000000000
00000000111111111000000111111111111100000011100000000000011111111111000000000000000000000000000
00000000111111111000000111111111111100000000000000000000000011111111000000000000000000000000000
00000000111111111000000111111111111100000000000000000000000011111111000000000000000000000000000
00000000000011111000000111111111111100000000000000000000000011111111000000000000000000000000000
00000000000011111000000111111111111100000000000000000000000011111111000000000000000000000000000
00000000000011111000000111111111111111110000000111100000000011111111000000000000000000000000000
00000000000011111000000111111111111111111100000100100000000011111111000000000000000000000000000
00000000000011111000000111111111111111111110000100100000000011111111000000000000000000000000000
00000000000011111000000111111111111111111110000100100000000011111111000000000000000000000000000
00000000000011111000000111111111111111111110000100100000000011111111000000000000000000000000000
00000000000011111000000111111111111111000000000100100000000011111111000000000000000000000000000
00000000000011111000000111111111111111111111001100110000000011111111000000000000000000000000000
00000000000011111000000111111111111111111111111100111111000011111111111110000000000000000000000
00000000000011111000000111111111111111111111111100011111100111111111111110000000000000000000000
00000000000011111000000111111111111001111100000000000000001111111111111110000000000000000000000
00000000000011111000000111111111111111100001111111111100011011111111111110000000000000000000000
00000000000011111000000111111111111110111101011111111110001111111111111110000000000000000000000
00000000000011111000000111111111111110111101011111111111101111000000000000000000000000000000000
00000000000011111000000111111111111110000001011111111110000111000000000000000000000000000000000
00000000000011111000000111111111111111111111011111111110000111000000000000000000000000000000000
00000000000011111000000000000000000000000000011111111110000111000000000000000000000000000000000
00000000000011111000000000000000000000000000011111111111111111111110000000000000000000000000000
00000000000011111000000000000000000011111111011111111111111111111110000000000000000000000000000
00000000000011111000000000000000000010111101011111111111111111111111111100000000000000000000000
00000000000011111000000000000000000010111101011111111111111111111111111100000000000000000000000
00000000000011111111111111111111000010111101000000000000000000000011111100000000000000000000000
00000000000011111111111111111111000010111101000000000000000000000011111100000000000000000000000
00000000000011111100000000000001100110111101000000000000000000000011111100000000000000000000000
00000000000011111100000000000000000000111101000000000000011101110111111110000000000000000000000
00000000000011111100000000000000000000111101111111111111111111111111111110000000000000000000000
00000000000011111100000000000000000000111101111111111111110111011101111110000000000000000000000
00000000000011111111111111111111000011111100000000000000000000000000011110000000000000000000000
00000000000011111111111111111111000011111111111111111111111111000011111110000000000000000000000
00000000000011111111111111111111000011111111111111111111111111000011111110000000000000000000000
00000000000011111100000000000000000000000000000000000000000000000000011110000000000000000000000
00000000000011111110000000000110000000110000000000110000000000000000011110000000000000000000000
00000000000000111111111111111111000011111111000111111111111111111111111110000000000000000000000
00000000000000111111111111111111100111111111000111111111111111111111111110000000000000000000000
00000000000000111111111111111111100111110000000001111111111111111111111000000000000000000000000
00000000000000111111111111111111100111110010000010011111111111111111111000000000000000000000000
00000000000000111111111111111111100111110010000010011111100000000000000000000000000000000000000
00000000000000111110000000001111100111110000010000011111100000000000000000000000000000000000000
00000000000000000000000000001111100111110000111000011111100000000000000000000000000000000000000
00000000000000000000000000001111100111110000010000011111100000000000000000000000000000000000000
00000000000000000000000000001111100111110010000010011111100000000000000000000000000000000000000
00000000000000000000000000001111100111110010000010011111100000000000000000000000000000000000000
00000000000000000000000000001111100111110000000000011111100000000000000000000000000000000000000
00000000000000000000000000001111100111111111111111111111100000000000000000000000000000000000000
00000000000000000000000000001111100111111111111111111111100000000000000000000000000000000000000
00000000000000000000000000001111100111111111111111111111100000000000000000000000000000000000000
00000000000000000000000000001111111111111111111111111111100000000000000000000000000000000000000
00000000000000000000000000001111111111111111111111111111100000000000000000000000000000000000000
00000000000000000000000000001111111111111110000000000000000000000000000000000000000000000000000
00000000000000000000000000001111111111111110000000000000000000000000000000000000000000000000000
00000000000000000000000000001111111111111110000000000000000000000000000000000000000000000000000
