-104
50
-76
37
00000000000000000000000000000000000000000000000000000000000000000000000000000000000000000000000000000000000000000000000000000000000000000000000000000000000
00000000000000000000000000000000000000000000000000000000000000000000000000001111111111100000000000000000000000000000000000000000000000000000000000000000000
01111111111111111111111111111111111111111111111111111011110000000000000000111000000000110000000000000000000000000000000000000000000000000000000000000000000
01000000000111000011111110000000000000000000000100001010010000000000000000100000000000010000000000000000000000000000000000000000000000000000000000000000000
01001110000011100010100000000000000000000000000100001110010000000000000000110000000000011000000000000000000000000000000000000000000000000000000000000000000
01011100000001000010100000000000000000000000000100000100011111100000000000010000000000001000000000000000000000000000000000000000000000000000000000000000000
01001000000000000011100000000000000000000000000100000000000000100000000011110000000000001000000000000000000000000000000000000000000000000000000000000000000
01000000000000000001000000000000000000000000000100000000000000100001111110000000000000001000000000000000000000000000000000000000000000000000000000000000000
01000000000100000000000000000000000000000000000100000000000000100111000000001111011111111000000000000000000000000000000000000000000000000000000000000000000
01000000000100000100001000000000000000000000000100000000000000101100000000110001100000001000000000000000000000000000000000000000000000000000000000000000000
01000000000000000000001000000000000000000000000100000000000000111000001111000000000111110000000000000000000000000000000000000000000000000000000000000000000
01000010000000000000001000000000100000000000000101100100000110001000001000000000001001110001111111100000000000000000000000000000000000000000000000000000000
01000000000000000000001000000000111111110000000100000000000000001110001000000000001111011111000000000000000000000000000000000000000000000000000000000000000
01000000011000000000001000000000111100010000000100000000000000001011000110000000000000001000000000000000000000000000000000000000000000000000000000000000000
01000010000000000000001000000000110100010000000101100000000000001001010010000000000000010000000000000000000000000000000000000000000000000000000000000000000
01000111000000000000001000000000110111110011110100000000000000001001000001000000000000010000000000000000000000000000000000000000000000000000000000000000000
01000010000000100000001000000000110000011110011101100000001100111011000000100111100000010000000000000000000000000000000000000000000011111100000000000000000
01000000000000000000001000000000110000000000000000000000010111101010000000011000100000010000000000000000000000000000000000000000000110000100000000000000000
01000000000000000000001000000000110000000000000000000000011111110010000000000000100000010000000000000000000000000000000000000000111100000100000000000000000
01110000000000000001101000000000110000000000000000001111110000000010000000000000111000001100000000000000000000000000000000000011100000000100000000000000000
00011000000000000000001000000000110000000000000000010000010000000111111111110000111100000110000000000000000000000000000000001110000000000100000000000000000
00001111111111110000001000111100110000000000000000011111100000011100000000010000100111000010000000000000000000000000000000001100000000000110000000000000000
00000000000000011000001111100111110000000000000000010001100000100100000010010000111111100011000000000000000000000000000000001000000000010010000000000000000
00000000000000001000001100000000110000000001111111110001011111000100000010010000100000110001100000000000000000000000000000111000000000000010000000000000000
00000000000000001111000000000000000000000011000000010010000001000100001110010000100000011000111100000000000000000000000000100000000000000110000000000000000
00000000000000001001100000000000000000000111111111100010000001000111111011110000100000001000100111100000000000000000000000100000000000001100000000000000000
00000000000000001111100000000000000000001100000000000010000001000000000011010000100000000111100000111000000000000000000000100000011000111000000000000000000
00000000000000000100100000000000000011111000000000000100000001000000000000010000100000000100000000001110000000000000011111100000001001100000000000000000000
00000000000000000100110000000000000100010000000000001100000001000000000000010000100000001100000000000011100000111111110011000000000011000000000000000000000
00000000000000000100011010000010000111100000000000010000000001000000000000010000111100001000000000000000111100001000000001110000000110000000000000000000000
00000000000000001000001110000010000100000000000000110000011001111000000111111111100111111000000000000000000100011000000001010000011100000000000000000000000
00000000000000110000100010000010001100000000000001000001100111001000000000000000100000010000000000000000000100010000000001010000110000000000000000000000000
00000000000000100000000000000011011000000000000010000010000001001000000000000000111000100000000000000000000011010000000001110000101110000000000000000000000
00000000000011100000000000000001110000000111111100000011100001001000000000000000000001100000000000000000000001010000000000000011101010000000000000000000000
00000000001100000000000000000000100000001000000000000000100110001000000000000000001110000000000000000000000001010000000000000100011010000000000000000000000
00000000011000000001110001000000000000010000000000000000111000001100000000000000110000000000000000000000000001010000000000000100110010000000000000000000000
00000000110000000001000000100000000000100111111111110000000000000111111000000011100000000000000000000000000001010000000000001000100010000000000000000000000
00000000100000011110000000010000000000101000000000011100000000011000011100000100000000000000000000000000000010010000000000001111100010000000000000000000000
00000000100000010001000000100000000001001000000000000100000001101111110110000011100000000011111000000000000011110000000000000000000010000000000000000000000
00000000100000110000000000100000000001001111111111111000000010111000000011000010000000001110001111000000000000000000000011111111000110000000000000000000000
00000001000011000000000000010000000001000000000000000000000100100000000001000000000000011000000001000000000011100000000010000001110100000000000000000000000
00000001000010000000000001100000000010000000000000000000000101100000000001000000000011110001110001000001111110100000000010000000010100000000000000000000000
00000110000010000000000110000000000100000000000000000000011001000011100001000010000000110101010001100010000000100000000010001111110100000000011111111100000
00011100000010010000000100000000000100000000000000000000100001111110100001000010000000011111011001110010000000100000000010001000000110000011100000000110000
00010000000011000000000110000000001000001111111000000001000010011010110011000100000000101100001001010010011111100000000011111000000011100100000000000010000
00011100000000100000000011000000010000010000000111111110000010000000010110000100000000001111001111010010100000100000000000000000000000111010000000000010000
00000100000000100000000000100000010000100000000000000000000100000000011100001000000000000001100000000010100000100000000000000000000000000000000000000010000
00000100000000111000000000100000100001000000000000000000001000000000001100001000000000000000000000000010100000100000000000000000000000000000000000000010000
00000100000000000100000000100001000010000000000000000000001000000001110000001000000000000000000000000010100000100000000000000000000000000000000000000010000
00000011000000000100000000111111000010000000000000000000001000000110000000010000000000000000000000000010100000100000000000000000000000000000011111001110000
00000000111000000111110000000000000010000000000000000000011100011000001111110001111100000000000001111111100000100000000000000000000000000000110001001000000
00000000000110000000001100000000000100111111111110000001110000000000010000100010000010000000000010000010000000100000000000000000000000000000100001111000000
00000000000001100000000111000000000111000000000001111111000000000000100000100010000010000000011110000100000000100000000000000000000000000000110000000000000
00000000000000010000000000100000000000000000000000001000000000000011000000100001100011111111100000001000000000100011111111111111111111111000010000000000000
00000000000000010000000000100000000000000000000000001000000000000100000000100000100000010010000000001000000000111110000000000000000000001110010000000000000
00000000000000001000000000100000000000000000000000001000000000001011000000100000100000010010000000001000000000001000000000000000000000000011110000000000000
00000000000000000100000000100000000000000011100000001000000000001001100000100000100000010010000000001000000000011111100000000000000000011110010000000000000
00000000000000000011111111000000000000111100011111001000000000011110111111100001100000010011111111111101100000110100100000000000000000010010011100000000000
00000000000000000000001000000000111111000000000000111000000000010000000100000010111111100011000000000101000000100100100000000110000000010010010110000000000
00000000000000000000001000000001000000000010000000001000000000100000000000001110100000100001000001110101000000100100111111111111111111110011010011000000000
00000000000000000000001010000010000000000010000000001000000000100000000000010001100000100001000001010111000000101100000000000000000000000001010001000000000
00000000000000000000001000000100111000000010000000000100000001000000000000110111000001100001001111010111110000101000000000000000000000000001010001000000000
00000000000000000000001000000011011000000010000000000111111111000000000001001000000011000001101011011111100000101000000000000000000000000001010001110000000
00000000000000000000001111000000001111111010000000001000000100000000000111001111111111000000011011000110000000101000000000000000000000000001010110011000000
00000000000000000000000001000000000000000010000000011000000100000000001000001110000001000000000000000000000000101100000000000000000000000011010000001000000
00000000000000000000001101110000000000001110000010100000001000000000001000010110000001000000000000000000000000100100111111111001111111110010010000001100000
00000000000000000000000001110011000000000001000001100000001000000000001000011111111000000000000000000000000000100100100000001001000000010010010000000110000
00000000000000000000000000011111000000000001000001100000010000000000010001111110101100000000000000000000000000100100100000001111000000010010010000000011000
00000000000000000000000100000111111011000001000001100000010111111000100001100010011000000000111111111111110000100100100000001001000000010010010000000001100
00000000000000000000000000000000001111000001000001100000001010001011000010100010011100000000100000000000010000100111111100000000000011111110010000000000100
00000000000000000000000000000000000111111001111111111000000010001110000010100010000010000111100000000000010000100000000100000000000010000000010000001100100
00000000000000000000000000000000000100001000000000100000000011111000000100011110100010000100000011110000010000100000000100000000000010000000010011000000100
00000000000000000000000000000000000111101000000011100000000000001000001001111111111010001100000010011100010000100000000111000000001110000000010000000000100
00000000000000000000000000000000000100001000000000000011110000011000110000000000000000000010000010000110010000100000000000000000000000000000010000000000100
00000000000000000000000000000111111111111100000000000110011000010001000000000000000000000011111110001010010000100000000000000000000000000000010000000000100
00000000000000000000000111111100000001010110000000011100001000010110000000000000000000000000000000000011110000100000000000000000000000000000010000000000100
00000000000000000000001100000000000001110011000000100000001110110100000000000000000000000000000000000011100000100000000000000000000000000000010000000000100
00000000000000000000001000010000000000010001000001000000111011101100000000000000000001101000000000000000000000100000000000000000000000000000010000000000100
00000000000000000000001111101000000000010000000000000000101111101000000000000000000000001000000000000000000000100000000000000000000000000000010000000000100
00000000000000000000001000100000000000010000000000000001100000010000000000000000000000000000000000000000000000100000000000000000000000000000010000000110100
00000000000000000000001000100000000000010000000000000011000001100010000000000000000000000000000000000000000000100000000000000000000000000000010001000000100
00000000000000000000001000100000000000010000000000011111111110000000000000000000000000000000000000000000000000100000000000000000000000000000010110000000100
00000000000000000000001000111111100011110000000000000000000000000000000000000000000000000000000000000000000000100000000000000000000000000000010000000000100
00000000000000000000111111110000000000000000000000000000000000000000000000000000000000000000000000000000000000100000000000000000000000000000010000000000100
00000000000000000001100000000000000000000000000000000000000000000000000000001111111111111111111000000000000000100000000000000000000000000000010000000000100
00000000000000000001000000000000000000000000000000011111111110000000000000001000000000000000001000001000000000100000000000000000000000000000010000000000110
00000000000000000001000000000000000000000000000000001100001011111111111111111000000000000000001000000000000000111111111110000000000011111111110000000000100
00000000000000000001000000000000000000000000000000001000001000000000000000000000000000000000001000000000000011000000001100000000000000000000000011000000100
00000000000000000001000000000000000000000001101101101000001000000000000011100000000000000000001001000000000011000100110000000000000000000000000000000000100
00000000000000000001000000000000000000000000000000001000001000111000111001100000000000000000001000000110000000000000110000000000000001000000000000000000100
00000000000000000001111111111100111111111111111111111000001000011000011000000000000000000000001000000110000000000000000000000000000110000000000000000000100
00000000000000000000001000000000000000011111000000011000001000000000000000000000000000000000001000000000000000000000000000000000000000000011000000000000100
00000000000000000000001001010011000000101111000000010000011000000100001001010000000000000000001000000000000000000000000000000000000000000000000000000000100
00000000000000000000001000100111111100000011000000010000010000000000000000000000000000000000001000000000000000000000000000000000000000000000000000000001100
00000000000000000000001001010001000101001011100001111100010000001111110100000000000000000000001001100000000000000000000000000000000000000000000010000001000
00000000000000000000001000000000000000000000111111000100010000001000010000000000000000000000001000000000010000000000000000000000000000000100000000000011000
00000000000000000000001000111111000000000000010001101100010000001000111110000000000000000000001000000000000000000000010000011000000011000000000000000110000
00000000000000000000001000100001000000001100100000111111111000111000100110000000000000000000001000000000000000110000000000000001000000000000000000011100000
00000000000000000000001000111111111000000000000000000000000000100000100000000000000000000000001000000000000000110000000000000000000000000000000001110000000
00000000000000000000001000000000111000000010000000100000000100100000100000000000000000000000001000000110000000000000000000000000000000000000000111000000000
00000000000000000000001110000000010000000011110111100111111100100000100000000000000000001111101011000000000000000000000000000000000000000001111100000000000
00000000000000000000001110000000000000000010000000000100010000100000100000000000000000001000101000000000000000000000000100011000000000000111110000000000000
00000000000000000000011000000000000000011010000000000100010000100000100000000000000000001000101000000000001000000011000000000000000110111100000000000000000
00000000000000000000010000000000000000000010000000001110010000111111100000000000000000001000100000000000001111111111111111111111111111100000000000000000000
00000000000000000000011000000000000000000000000011111000011000000000000000000000000000001000010000000000111100000000000000000000000000000000000000000000000
00000000000000000000011000000000000000000001111110000000001111111111000000000000111111100111110000001111100000000000000000000000000000000000000000000000000
00000000000000000000010000001111011111111111000000000000000000000001111111000011100000010000000111111100000000000000000000000000000000000000000000000000000
00000000000000000000011000011001110000000000000000000000000000000000000001111110000000001111111100000000000000000000000000000000000000000000000000000000000
00000000000000000000001111110000000000000000000000000000000000000000000000000000000000000000000000000000000000000000000000000000000000000000000000000000000
00000000000000000000000010000000000000000000000000000000000000000000000000000000000000000000000000000000000000000000000000000000000000000000000000000000000
00000000000000000000000000000000000000000000000000000000000000000000000000000000000000000000000000000000000000000000000000000000000000000000000000000000000
00000000000000000000000000000000000000000000000000000000000000000000000000000000000000000000000000000000000000000000000000000000000000000000000000000000000
00000000000000000000000000000000000000000000000000000000000000000000000000000000000000000000000000000000000000000000000000000000000000000000000000000000000
00000000000000000000000000000000000000000000000000000000000000000000000000000000000000000000000000000000000000000000000000000000000000000000000000000000000
